vieillards -> old men
ainsi -> thus
veiller -> to watch over
congé -> leave
pareille -> similar
en somme -> in short
doute -> doubt
deuil -> mourning
revêtu -> dressed
de peine -> of sorrow
étourdi -> dizzy
cravate -> tie
emprunter -> borrow
brassard -> armband
couru -> run
manquer -> miss
pendant -> during
presque -> almost
tassé -> crammed
chemin -> path
serré -> tight
trop -> too
seul -> alone
soutien -> support
reprochait -> reproached
subvenir -> to meet
besoins -> needs
ajouté -> added
loin -> far
partager -> share
eux -> them
pleurait -> cried
au bout -> at the end
dernière -> last
prenait -> took
l'écoutais -> listened to him/her
meurt -> dies
reprenaient -> resumed
jacassement -> chatter
assourdi -> muffled
perruches -> parakeets
disparue -> disappeared
paraît-il -> apparently
exprimé -> expressed
remercié -> thanked
athée -> atheist
blanchie -> whitened
chaux -> lime
recouverte -> covered
couvercle -> lid
brou -> pulp
noix -> nut
bégayé -> stuttered
dévisser -> to unscrew
n'aurais -> would not have
s'approchait -> approached
tortillant -> twisting
arrière -> back
sortie -> exit
le tour de la tête -> around the head
bandeau -> headband
gênait -> bothered
l'aurait -> would have
je me suis souvenu -> I remembered
surtout -> especially
courir -> to run
corbillard -> hearse
tais-toi -> shut up
raconter -> to tell
rougi -> reddened
indigent -> needy
garde -> guard
tombé -> fallen
épaissie -> thickened
au-dessus -> above
aveuglé -> blinded
l'éclaboussement -> splashing
soudain -> sudden
aucune -> none
chaises -> chairs
empilé -> piled
autour -> around
tasses -> cups
tricotait -> was knitting
réchauffé -> reheated
somnolé -> dozed
frôlement -> brushing
éclatante -> dazzling
courbes -> curves
dessinaient -> drew
pureté -> purity
blessante -> hurtful
dizaine -> dozen
glissaient -> slipped
aveuglante -> blinding
grinçât -> creak
m'échappait -> escaped me
ressortir -> to go out again
lueur -> glow
hoché -> nodded
s'agissait -> it was about
saluaient -> greeted
aperçu -> glimpsed
dodeliner -> to nod
compagnes -> companions
affaissés -> slumped
pleurait -> cried
bredouillé -> stammered
liée -> linked
faisaient -> made
pénible -> painful
singulier -> singular
apercevaient -> perceived
agrippés -> gripping
canne -> cane
crachait -> spat
mouchoir -> handkerchief
carreaux -> tiles
en sortant -> going out
se promener -> to walk
auparavant -> before
rayé -> scratched
l'espèce -> kind
suivre -> follow
vieil -> old
interdit -> prohibited
bâtiment -> building
chœur -> choir
baissait -> lowered
coup -> blow
enfoncées -> embedded
prêtre -> priest
prières -> prayers
bière -> beer/coffin
drap -> sheet
suivants -> following
déléguée -> delegated
nous avons suivi -> we followed
feutre -> felt
calotte -> skullcap
ronde -> round
ôté -> removed
nœud -> knot
d'étoffe -> fabric
lèvres -> lips
ballantes -> dangling
ourlées -> hemmed
curé -> parish priest
fermant -> closing
chaleur -> heat
collines -> hills
menaient -> led
pays -> country
devait -> had to
trêve -> truce
tressaillir -> to shudder
nous nous sommes mis en marche -> we started walking
claudiquait -> limped
prenait -> took
vieillard -> old man
laquelle -> which
bourdonnait -> buzzed
crépitements -> crackling
mouchoir -> handkerchief
s'essuyait -> was wiping
crâne -> skull
montrant -> showing
tape -> tap
chiffre -> number
feutre -> felt
hâtait -> hurried
l'éclat -> brightness
goudron -> tar
enfonçaient -> sank
pulpe -> pulp
cuir -> leather
bouilli -> boiled
gluant -> sticky
terne -> dull
pétri -> kneaded
laqué -> lacquered
crottin -> dung
vernis -> varnish
l'encens -> incense
nuée -> cloud
chaleur -> heat
pris -> took
coupait -> cut
rattraper -> to catch up
tournant -> turning
insolation -> sunstroke
larmes -> tears
ruisselaient -> streamed
rides -> wrinkles
s'étalaient -> spread
se rejoignaient -> joined
détruit -> destroyed
pantin -> puppet
racines -> roots
mêlaient -> mixed
nid -> nest
