
l'aumônier -> the chaplain
allongé -> lying
je ne vois que lui -> I only see him
eussent échappé -> had escaped
saut -> jump
l'espoir -> hope
imperturbable -> unflappable
je ne l'avais pas connu -> I had not known him
j'écrasais -> I crushed
empoisonée -> poisoned
recroquevillais -> curled up
couperet -> guillotine
lequel -> which one
souhaitât -> would wish
marchât -> would walk
accroc -> snag
machine -> machine
fusse -> were
aspect -> appearance
l'échafaud -> the scaffold
honte -> shame
tandis -> while
l'aube -> dawn
pourvoi -> appeal
m'efforçais -> I tried
je finissais par me dire que... -> I ended up telling myself that...
contraindre -> to constrain
l'aube -> dawn
naisse -> be born
vitre -> glass
guettais -> was watching
rauque -> hoarse
tout le monde sait que la vie ne vaut pas la peine d'être vécue -> everyone knows that life is not worth living
dans le fond -> deep down
bond -> leap
frottées -> rubbed
adossé -> leaning
musclée -> muscular
cuisses -> thighs
réellement -> really
agacement -> irritation
étroite -> narrow
remuer -> to move
s'il n'osait avancer -> if he dared not move forward
avais-je cherché un visage -> had I sought a face
fût -> was
valait -> was worth
l'aumônier -> the chaplain
menaçaient -> threatened
épuisé -> exhausted
tempes -> temples
d'étoiles -> of stars
tendre -> tender
restait -> remained
souhaiter -> to wish
m'accueillent -> welcome me
cris -> cries
haine -> hatred
