plaidoiries -> pleadings
gênait -> bothered
démontrer -> demonstrate
preuve -> proof
l'éclairage -> lighting
fournira -> will provide
âme -> soul
événements -> events
manquait -> was missing
besogne -> task
moi j'écoutais -> I was listening
seule -> alone
ému -> moved
m'accabler -> overwhelm me
mais tant d'acharnement m'étonnait -> but such perseverance surprised me
muer -> to change
saurions -> would know
gouffre -> abyss
selon -> according to
osait -> dared
faiblesse -> weakness
cédait -> yielded
craignait -> feared
ressentait -> felt
tuait -> killed
meurtrière -> murderer
son devoir -> his duty
léger -> light
ressens -> feel
mêlant -> mixing
donné -> given
penché -> leaned
plaidé -> pleaded
honnête -> honest
soutenu -> supported
m'étonne -> surprises me
mené -> led
je me souviens -> I remember
assailli -> assaulted
m'appartenait -> belonged to me
gorge -> throat
traînais -> dragged
châtiments -> punishments
douceur -> sweetness
souriait -> smiled
meurtre -> murder
cassation -> appeal
éloignés -> distant
pourvoi -> appeal
tranchée -> trench
lisais -> was reading
emmené -> taken
recevoir -> receive