cabanon -> cabin
raccrocher -> to hang up
transmettre -> to transmit
tout de suite -> right away
parmi -> among
lesquels -> which
traiterait -> would treat
permettrait -> would allow
fond -> bottom
mécontent -> unhappy
désastreux -> disastrous
réelle -> real
doute -> doubt
tue -> kills
taisais -> was keeping silent
souriant -> smiling
dès -> from
cours -> courses
vécu -> lived
c'est sale -> it’s dirty
peau -> skin
saccadés -> jerky
débarassée -> rid
fiévreusement -> feverishly
jaquette -> jacket
assise -> sitting
empêtré -> entangled
reprocher -> to blame
remarquait -> noticed
précipitée -> hasty
carré -> square
sac -> bag
pourboire -> tip
gousset -> watch pocket
chemin -> path
sûreté -> safety
perdre -> to lose
sur mes pas -> on my steps
écrasé -> crushed
celui-là -> that one
accroupi -> crouched
chaise -> chair
mâchonnait -> was chewing
sommeil -> sleep
fer -> iron
bec -> beak
pommade -> ointment
pauvre -> poor
bâillé -> yawned
remercié -> thanked
gêné -> embarrassed
l'asile -> asylum
jugeât -> would judge
puisque -> since
furtif -> stealthy
geste -> gesture
écailles -> scales
n'aboieront -> will not bark
