arrestation -> arrest
plusieurs -> several
juge -> judge
avocat -> lawyer
lieu -> place
chargeât -> charged
tendue -> tense
rideaux -> curtains
semblable -> similar
tué -> killed
enquête -> investigation
gêne -> discomfort
col -> collar
souhaité -> wished
mourût -> died
témoins -> witnesses
greffier -> clerk
jusqu'ici -> until now
en arrière -> backward
preciser -> specify
suivi -> followed
s'agiter -> fidget
il s'est assis -> he sat down
fourragé -> rummaged
coudes -> elbows
penché -> leaned
disiez -> said
classeur -> binder
brandi -> brandished
devînt -> became
prête -> ready
accueillir -> welcome
mouches -> flies
hauteur -> height
chrétien -> Christian
fautes -> mistakes
cordiaux -> cordial
mêlait -> mixed
m'étonnais -> surprised me
presque -> almost
remettait -> put back
gendarmes -> police officers
