cette partie -> this part
réllement -> really
événement -> event
traversin -> bolster
punaises -> bedbugs
isolé -> isolated
bat-flanc -> bunk
cuvette -> bowl
barreaux -> bars
baie -> bay
coupaient -> cut
bruni -> browned
rejaillissait -> sprang
tue-tête -> deafening noise
par-dessus -> over
tu sortiras et on se mariera? -> you will come out and we will get married?
prendrait encore -> would still take
coûtait cher -> cost a lot
se gonfler -> swell
baie -> bay
îlot -> island
prenait -> took
baisser -> lower
sourire écartelé -> forced smile
étreindre -> embrace
tuait -> killed
mais, a-t-il dit, c'est justement pour ça ...? -> but, he said, that's exactly why ...?
abattu -> downcast
suçais -> sucked
fêlure -> crack
ébréché -> chipped
paillasse -> straw mattress
l'étoffe -> fabric
pendue -> hanging
tellement -> so much
gamelle -> mess tin
cortège -> procession
lucarne -> skylight
puisque -> since
