tromper -> to deceive
connaissements -> bills of lading
s'amoncelaient -> were piling up
brûlant -> burning
chaînes -> chains
noyé -> drowned
poussière -> dust
mâts -> masts
élan -> momentum
treuils -> winches
longions -> we were following
pavés -> cobblestones
inégaux -> uneven
haleine -> breath
quais -> docks
heurté -> hit
palier -> landing
l'épagneul -> the spaniel
poils -> hairs
rougeâtres -> reddish
mène -> leads
bute -> hits
bat -> beats
rampe -> railing
frayeur -> fright
terreur -> terror
haine -> hatred
par hasard -> by chance
d'ailleurs -> besides
gémissait -> was groaning
devinais -> guessed
penché -> leaned
bête -> beast
métier -> trade
pourtant -> however
guère -> hardly
dégoûtait -> disgusted
boudin -> pudding
ceau -> basin
m'éviterait -> would avoid me
ange -> angel
stuc -> stucco
défait -> undone
sale -> dirty
pansement -> dressing
douteux -> doubtful
cherchait -> was looking for
bagarre -> fight
méchant -> mean
ça vaut mieux -> it's better that way
tombé -> fell
relever -> to pick up
coup de genou -> knee hit
taquets -> cleats
compte -> account
pansement -> dressing
égal -> equal
poêle -> stove
mangeant -> eating
installés -> settled
autant -> as much
entretenue -> maintained
tromperie -> deceit
mois-ci -> this month
loyer -> rent
modde-piéte -> doormat
tapée -> batch
bonheur -> happiness
jusqu'au -> until
auparavant -> before
volets -> shutters
punie -> punished
charbonnait -> was charring
restait -> remained
emportaient -> were carrying away
lointains -> distant
coït -> coitus
l'emmener -> to take him/her
mœurs -> morals
réfléchir -> to reflect
punir -> to punish
découvert -> discovered
cracherait -> would spit
mettrait -> would put
dehors -> outside
rédiger -> to write
assiettes -> plates
soigneusement -> carefully
toile -> canvas
tiroir -> drawer
feuille -> sheet
quadrillé -> squared
encrier -> inkwell
carré -> square
d'encre -> ink
hochant -> nodding
tutoyait -> was addressing informally
frappé -> struck
cacheté -> sealed
glissement -> sliding
sommeil -> sleep
palier -> landing
cage -> cage
d'escalier -> of stairs
bourdonnait -> was buzzing
souffle -> breath
gémissait -> was groaning
