surviendrait -> would occur
demie -> half
darmes -> weapons
remueménage -> hustle and bustle
menottes -> handcuffs
jurés -> jurors
épaient -> spied
niaise -> naive
puisque -> since
belette -> weasel
engraisée -> fattened
narquois -> mocking
bleue -> blue
témoins -> witnesses
sein -> breast
disparaître -> disappear
moindre -> slightest
voyais -> saw
paille -> straw
tressée -> braided
aussitôt -> immediately
agacement -> annoyance
toussé -> coughed
feuilleté -> leafed through
s'éventant -> fanning oneself
touchaient -> touched
de fort près -> very close
soigner -> take care of
coûté -> cost
conciliabules -> whisperings
chaleur -> heat
munis -> equipped
plaignait -> complained
manie -> habit
plaindre -> pity
c'est la loi -> it's the law
un tel éclat -> such a burst
j'ai senti combien j'etais détesté -> I felt how much I was hated
posait -> posed
coupable -> guilty
d'étonnement -> of amazement
bruyamment -> noisily
apprécieront -> will appreciate
concluront -> will conclude
soutenir -> support
m'empêchait -> prevented me
évanoui -> fainted
fâché -> angry
péremptoire -> peremptory
piquait -> stung
jetait -> threw
roulait -> rolled
panama -> Panama hat
mettre -> put
col -> collar
renfermé prétoire -> courtroom
coudes -> elbows
genoux -> knees
émue -> moved
sanglots -> sobs
poursuivie -> pursued
forçait -> forced
paraissait -> seemed
emmené -> taken
haïr -> to hate
méfaits -> misdeeds
giflé -> slapped
crapuleux -> scoundrel
débauche -> debauchery
honteuse -> shameful
amidonée -> starched
souteneur -> pimp
exerçait -> exercised
plis -> folds
haussé -> raised
plainte -> complaint
d'aveugle -> of a blind person
mener -> to lead
