mécontent -> unhappy
façon -> way
m'empêche -> prevents me
passe -> pass
bouée -> buoy
effleuré -> touched lightly
vers -> towards
hissé -> hoisted
doré -> golden
nuque -> nape
battre -> to beat
moitié -> half
suivie -> followed
taille -> size
nagé -> swam
brune -> brunette
séchions -> we were drying
rhabillés -> dressed again
deuil -> mourning
fautif -> at fault
bête -> beast
jambe -> leg
traversin -> bolster
cuire -> to cook
chaises -> chairs
paille -> straw
dû -> owed
jaunie -> yellowed
cuivre -> copper
découpé -> cut out
cahier -> notebook
mets -> dishes
journaux -> newspapers
faubourg -> suburb
cependant -> however
empêtres -> entangled
genou -> knee
culotte -> shorts
nœud -> knot
marron -> brown
soie -> silk
frêle -> frail
canotier -> boater hat
papillon -> butterfly
voyant -> visible
disait -> said
laqués -> lacquered
cintré -> fitted
pochette -> pocket square
brodée -> embroidered
bouts -> ends
carrés -> squares
dépêchaient -> hurried
ficus -> fig tree
trottoir -> sidewalk
tabac -> tobacco
enfourchée -> straddled
bondés -> crowded
balayait -> swept
sciure -> sawdust
morceau -> piece
orage -> storm
pluie -> rain
stade -> stadium
banlieu -> suburb
marchepieds -> footrests
ramené -> brought back
jouers -> cheeks
hurlaient -> were screaming
poumons -> lungs
périrait -> would perish
rougeâtre -> reddish
revenaient -> were coming back
aussitôt -> immediately
parmi -> among
paraisaient -> appeared
songeurs -> thoughtful
croiser -> to cross
pâlir -> to pale
étoiles -> stars
mouillé -> wet
sourire -> smile
cheveux -> hair
cou -> neck
fraîchi -> freshened
fermé -> closed
tiré -> pulled
