raies -> stripes
resserrée -> tightened
roseaux -> reeds
rochers -> rocks
tiède -> lukewarm
paresseuses -> lazy
jouersnageant -> cheeks swimming
crête -> crest
dentelle -> lace
l'écume -> foam
disparaissait -> disappeared
mousseuse -> foamy
retombait -> fell back
tiede -> lukewarm
l'amertume -> bitterness
lèvres -> lips
rafraîchissait -> refreshed
jeter -> to throw
couler -> to flow
déjeunerions -> would have lunch
griffes -> claws
semelles -> soles
charogne -> carrion
manches -> sleeves
éclaté -> burst
manquer -> to miss
aiguë -> sharp
hurlé -> screamed
empli -> filled
plombier -> plumber
locataire -> tenant
pleuré -> cried
ouvert -> open
doucereux -> sweetish
giflé -> slapped
volée -> flight
claque -> slap
ramasser -> to pick up
mégot -> cigarette butt
guignol -> puppet
maquereau -> pimp
fermer -> to close
gueule -> mouth
soûl -> drunk
honte -> shame
trembler -> to tremble
avis -> opinion
témoin -> witness
bordel -> mess
fine -> fine
marmonnait -> was mumbling
fouiller -> to search
emmené -> taken
volubilité -> volubility
baraque -> shack
foraines -> fairs
collier -> necklace
s'égarer -> to get lost
malgré -> despite
recueillait -> collected
croûtes -> scabs
fourrière -> pound
crever -> to burst
souliers -> shoes
craqué -> cracked
cloison -> partition
lendemain -> next day
