secoue -> shakes
amer -> bitter
toile -> canvas
lâché -> let go
témoigné -> testified
se dépêcher -> to hurry
pierres -> stones
jaunâtres -> yellowish
asphodèles -> asphodels
cirée -> waxed
éparpiller -> scatter
enfouies -> buried
cap -> cape
chalutier -> trawler
cueilli -> picked
pilotis -> stilts
friture -> frying
jolie -> pretty
épatante -> amazing
éprouver -> to feel
tic -> tic
plongé -> plunged
jeté -> thrown
nageait -> was swimming
écartait -> was moving aside
coulaient -> were flowing
voiles -> sails
paraissait -> appeared
battant -> flapping
plat -> flat
visqueuse -> viscous
chaleurs -> heats
secoué -> shaken
déjeuner -> lunch
étaler -> spread
déjà -> already
plaisais -> pleased
étonnés -> surprised
vaisselle -> dishes
surplombaient -> overhung
chaleur -> heat
vécu -> lived
moitié -> half
nue -> naked
bagarre -> fight
surchauffé -> overheated
ralenti -> slowed
bulles -> bubbles
couteau -> knife
tailladée -> slashed
osé -> dared
bouger -> to move
tenir -> to hold
enfuis -> fled
cloués -> nailed
serré -> tight
dégouttant -> dripping
soutenu -> sustained
roseau -> reed
écrasant -> crushing
brisait -> was breaking
source -> source
graisseux -> greasy
l'œil -> the eye
glissé -> slipped
bois -> wood
retentissante -> resounding
pénible -> painful
haletait -> was panting
gonfler -> to swell
poings -> fists
ivresse -> drunkenness
coquillage -> seashell
jaillie -> sprang
crispaient -> were tensing
aveuglant -> blinding
fuir -> to flee
eau -> water
dos -> back
soulevé -> lifted
veston -> jacket
paupières -> eyelids
n'avançait -> did not advance
l'ancre -> the anchor
tache -> stain
j'en ai deviné -> I guessed
demi-tour -> U-turn
brûlure -> burn
joues -> cheeks
j'ai fait un pas, un seul pas en avant -> I took a step, just one step forward
l'acier -> steel
giclé -> spurted
étincelante -> sparkling
tiède -> lukewarm
épais -> thick
cymbales -> cymbals
glaive -> sword
jailli -> sprang
rongeait -> was gnawing
cils -> eyelashes
charrié -> carried
pleuvoir -> to rain
gâchette -> trigger
ventre -> belly
crosse -> handle
assourdissant -> deafening
balles -> bullets
brefs -> brief
parût -> appeared
malheur -> misfortune
